12 10 7
PPXPXPPPPPXG
XPPPPPPPPGPP
PSGPXPPPGXPX
PPPPXPPPPPPP
XPXPPPXPGPPP
PPXPXPPPPPPP
PPPPPXPXXPPE
PXPPXGPPXPPP
PPXXPPXPPPPP
XPPPXXXPXXXG
