8 8 5
XPPXXXXX
XXXPXPXX
PPXPPXPP
XXEXPPPP
PPXGPGSX
PPGXPXXG
PPXPXPPX
PPGXXXPP
