11 5 4
XGXPXPXXSXX
XPGPXXXXPXP
XXXXPXXXXPP
PXPPXGXXEXP
XXGXXXXXPXX
