9 5 3
XXXXPXXPX
XXPXXPPXP
XXXXXGXXX
XXGPPPXEX
XGXPXSXXP
