9 9 4
XPXPXXXPP
XPPXXPXXX
XPEPPPPXP
PPPXPXXPX
XXPPPXXXX
XGPXXGPPP
XPXXPPXXX
XXPGSXXPX
PGXXXXXXX
