12 6 7
PPPPPPXPXEPG
PPPXPXXXPPPP
XPPPGPPPXXXP
SXGPPPPPPGXG
PPXPPPPXPPPX
XPGGPXPPPPPP
