10 9 6
PPXXPXXXXX
PXGGPXGXPP
XXXXXXXXXP
XXXPXXPXXX
XPXXXXPXXX
XPXPPXXXPX
GXXXXXGXXP
XXXXXXXPPX
XEXXXPXSGP
