12 9 7
PXPGXXXPPPPP
XPPXXPPPXXPP
PPXXPPPXXPPP
PPPGPPGXPPPX
XPPPSPXGXXXX
PXPXPGPPXPXP
PXPPXEPGPPPX
PPPXPPPPPGPP
XXPXXPPPPPPP
