11 10 4
PPPXPPPPPPP
PSPPGPPPPPP
PPPPPPPPXPP
PGPPPPPPXPP
PPPXPGPPPPP
PXPPEPPPPPP
PPPPXPXPPPP
PPPPPPPPPPP
XPPPPPPPGPX
PPPXXPPPPPP
