10 12 6
PPPPPPPXPP
GPPPPPPPXP
PPPPPPXSPG
PPPGPPGPPP
PXPPPPPPXX
XPPPPPPPPP
PPPPPPPPPP
PPGPPPPPPP
PPPXXPXPPP
PPPPXPPGXP
PPPPPEPPPP
PPPPXPPPPP
