11 6 5
XXXGPXXXXXX
XPPPXXPXGXX
PXXXXXGXXXX
XSXPXPXPGXX
GXPPPEXXPPP
XXXXXXPXXXP
