10 8 3
PPPXXPXPXP
PPPXXXXXXP
PPPPXXXXPP
PGPPPPXPPP
PXXPPPPPPP
XPPPSXXXXE
GXXXPPPXPX
PPPPPPPXXG
