8 9 3
XXXPXXPP
XPPXXXXP
GPXXXXXX
XXPXXEXP
XXXXXSGX
XXPXPXPX
PXXPXXXP
XXGXXXXP
PPXXXPXX
