11 9 3
PXXXXXXPSPP
PPPXXXXPPXX
XXXXXXXPXPX
XXXXXXPXXXP
PXXXPPPXXPP
GXPGXXXPXXX
EXPXXXXXXPP
PXPXPXXPPPX
XPXPXXXXGPX
